----------
-        -
-        -
-        -
-        -
-        -
-        -
-        -
-        -
-        -
-        -
-        -
-        -
-        -
-        -
-        -
-        -
J *  r x O
----------
