----------
J     BB*-
-B       -
-B       -
-        -
-B      --
-        -
-    -   -
-      ---
-     ----
--    ----
---      -
------   -
-----    -
-----   B-
----    B-
-r x    B-
-  -     O
----------
