----------
-        O
-  -    --
- --B  B -
-        -
-        -
- -  B   -
-$-  B-  -
---R     -
-$B  -   -
-    -   -
------ Q--
- $  -   -
-    -   -
-        -
-        -
-Q Q Q   -
J        -
----------
