----------
-        -
-  Q     -
-        -
-        -
-     R  -
-        -
-        -
-        -
-        -
-        -
-  N B   -
-        -
-        -
-        -
-        -
-        -
J *  r x O
----------
