----------
-R  -    O
--      --
-   R-   -
-    R-R -
-     R- -
-   -R   -
- R---R  -
- -----  -
-  *-rx --
------- R-
-  ---R  -
-   -R   -
- R      -
- R --  R-
-   R    -
- -   - --
J - -    -
----------
