----------
-  NN-   O
-       N-
-        -
-N    N --
-      ---
-   ------
-   ------
-  N------
-     - r-
-     x  -
- N  N----
-  N------
-   ------
-   ------
-   N   N-
-N       -
J    N  *-
----------
