----------
-        O
-        -
-        -
-        -
-        -
-        -
-        -
-        -
-        -
-        -
-        -
-        -
-        -
-        -
-        -
-        -
J        -
----------
