----------
-        O
-  -R    -
-   -R   -
-    -   -
-     -  -
-     R---
-        -
-     R- -
-      - -
-      -*-
-   ------
-        -
-        -
-   -RR  -
-   ---  -
-R R- x  -
J   -r-  -
----------
