----------
-        -
-        -
-        -
-        -
-     R  -
-        -
-        -
-        -
-        -
-        -
-  K     -
-        -
-        -
-        -
-        -
-        -
J *  r x O
----------
