----------
-        -
-   R    -
-        -
-        -
-     R  -
-        -
-        -
-       R-
-R       -
-        -
-  R     -
-        -
-        -
-        -
-        -
-        -
J *  r x O
----------
